1111111111111111111111
1E0000000000000C000C01
1010010100100000101001
1010010010101010001011
1P0000000C00C000000001
1111111111111111111111
