11111
10E01
10P01
10C01
11111
